###############
#             #
#   P      ####
#             #
#######       #
#  O ##  O    #
#    ##       #
#             #
#       XX    #
#       #     #
###############
